plugin keymaps:

<leader>
lsp:
   ll - hover
   lk - definition
   lm - code action
trouble
   xw - workspace diagnostics
   xd - document diagnostics
   xx - toggle
   xq - quickfix
   xl - locallist
   xr - lsp references
telescope
   ff - find files
   fd - live grep
   fm - manpages
   fq - quickfix
   ft - treesitter
none-ls
   w - format
buffers
   bd - buffer delete
   bc - buffer prev
   bv - buffer next
cmp
   <C-e> - close
   <C-q> - complete
neotree
   rr - file explorer
   rw - buffers
   rv - git
   rq - close


<non-leader>
comment
   gc - comment
